################
#              #
#     P        #
#         X    #
#              #
#            O #
################